{
    "0": ["e","e","e","e","e","e","e","e","e","e","e","e","e"],
    "1": ["e","1","x","b","b","b","b","b","b","b","x","3","e"],
    "2": ["e","x","s","b","s","b","s","b","s","b","s","x","e"],
    "3": ["e","b","b","b","b","b","b","b","b","b","b","b","e"],
    "4": ["e","b","s","b","s","b","s","b","s","b","s","b","e"],
    "5": ["e","b","b","b","b","b","b","b","b","b","b","b","e"],
    "6": ["e","b","s","b","s","b","s","b","s","b","s","b","e"],
    "7": ["e","b","b","b","b","b","b","b","b","b","b","b","e"],
    "8": ["e","b","s","b","s","b","s","b","s","b","s","b","e"],
    "9": ["e","b","b","b","b","b","b","b","b","b","b","b","e"],
    "10": ["e","x","s","b","s","b","s","b","s","b","s","x","e"],
    "11": ["e","4","x","b","b","b","b","b","b","b","x","2","e"],
    "12": ["e","e","e","e","e","e","e","e","e","e","e","e","e"]
}